WWWWWWWWWWWWWWWWWWWW
WB................1W
WWWcWWWWWccWWWWWcW.W
W......1WccW.......W
W.WWWWWWWccW.WWWWW.W
W..W......cW.W.....W
WWcW.WWWW....W.c...W
W..W.cccW..WWW.cc..W
WcWW...........ccc.W
W.WWWWWWccccccWWWWWW
W.W.cc.............W
WcW.cW.WWWWWWWWWWccW
WcW.cW.............W
W.W.cWWccWWWWWWWc..W
W1.......cWcc.....1W
WWWWWWWWWWWWWWWWWWWW