WWWWWWWWWWWWWWWWWWWW
WB...........W3....W
W.WWWWWWWWWW.W.WWW.W
W..........W.W.W.W.W
W.W.WWWWWW.W.W.W.W.W
W.W......W.W.W.W.W.W
W.WWWWWW.W.Wc.cW.W.W
W......W.W.WWWWW.W.W
W..WWW.W.W.......W.W
W..WcW.W.WWWWWWWWW.W
W.cW.W.W.Wc3.......W
W.WW.W.W.WWWWWWWWW.W
W....W.W........cW.W
WWWWWW.WWWWWWWWWWW.W
W3.....Wc.........3W
WWWWWWWWWWWWWWWWWWWW