WWWWWWWWWWWWWWWWWWWW
WB................1W
W..WWWWWWccWWWWWW..W
W..W1....cc.....W..W
W..W..WWWccWWW..W..W
W..W..W..cc.2W..W..W
W..W..W..cc..W..W..W
W..cccccccccccccc..W
W..cccccccccccccc..W
W..W..W..cc..W..W..W
W..W..W2.cc..W..W..W
W..W..WWWccWWW..W..W
W..W.....cc....1W..W
W..WWWWWWccWWWWWW..W
W1.................W
WWWWWWWWWWWWWWWWWWWW